R 1920 1080
NO ./textures/wall.xpm
SO ./textures/wall1.xpm
	
WE ./textures/wall3.xpm
EA ./textures/wer.xpm

S ./textures/ded.xpm
F 220,	 220, 0
C 225,30,0

        1111111111111111111111111
        1000000000110000000000001
        1011000001110000000000001
        1001000000000000000000001
111111111011000001110000000000001
100000000011000001110111110111111
11110111111111011100000000001
11110111111111011101010002001
10000000000000001100000022221
10000000000000001101010002E21
11000001111010111110111102221
11110111 1110101 101111010001
11111111 1111111 111111111111 
