R  1920 1080
NO ./textures/wall.xpm
SO ./textures/wall5.xpm

WE ./textures/wall1.xpm
EA ./textures/wer.xpm

S ./textures/ded.xpm
F 36,21,16
C 61,40,33

1111111111111111
1222222222222221
122222000000W001
1222222222222001
1111111110000111
        100001
        100001
        111111
